1,0,0,0,0,0,0,0,0,1
1,1,0,0,0,0,0,0,1,1
0,1,1,0,0,0,0,1,1,0
0,0,1,1,0,0,1,1,0,0
0,0,0,1,1,1,1,0,0,0
0,0,0,0,1,1,0,0,0,0
0,0,0,0,0,0,0,0,0,0
0,0,0,0,0,0,0,0,0,0
0,0,0,0,0,0,0,0,0,0
0,0,0,0,0,0,0,0,0,0
0,0,0,0,0,0,0,0,0,0
0,0,0,0,0,0,0,0,0,0


--
FF0000,0,0,0,0,0,0,0,0,FF0000
0000FF,0000FF,0,0,0,0,0,0,0000FF,0000FF
0,FFFF00,FFFF00,0,0,0,0,FFFF00,FFFF00,0
0,0,00FFFF,00FFFF,0,0,00FFFF,00FFFF,0,0
0,0,0,FF00FF,FF00FF,FF00FF,FF00FF,0,0,0
0,0,0,0,FF00FF,FF00FF,0,0,0,0
0,0,0,0,0,0,0,0,0,0
0,0,0,0,0,0,0,0,0,0
0,0,0,0,0,0,0,0,0,0
0,0,0,0,0,0,0,0,0,0
0,0,0,0,0,0,0,0,0,0
0,0,0,0,0,0,0,0,0,0
++
0,0,0,0,0,0,0,0,0,0
1,1,1,1,1,1,1,1,1,1
1,1,1,1,1,1,1,1,1,1
1,1,1,1,1,1,1,1,1,1
1,1,1,1,1,1,1,1,1,1
1,1,1,1,1,1,1,1,1,1
1,1,1,1,1,1,1,1,1,1
0,0,0,0,0,0,0,0,0,0
0,0,0,0,0,0,0,0,0,0
0,0,0,0,0,0,0,0,0,0
0,0,0,0,0,0,0,0,0,0
0,0,0,0,0,0,0,0,0,0
--
0,0,0,0,0,0,0,0,0,0
CCCCCC,CCCCCC,CCCCCC,CCCCCC,CCCCCC,CCCCCC,CCCCCC,CCCCCC,CCCCCC,CCCCCC
00FF00,00FF00,00FF00,00FF00,00FF00,00FF00,00FF00,00FF00,00FF00,00FF00
FF0000,FF0000,FF0000,FF0000,FF0000,FF0000,FF0000,FF0000,FF0000,FF0000
0000FF,0000FF,0000FF,0000FF,0000FF,0000FF,0000FF,0000FF,0000FF,0000FF
FFFF00,FFFF00,FFFF00,FFFF00,FFFF00,FFFF00,FFFF00,FFFF00,FFFF00,FFFF00
00FFFF,00FFFF,00FFFF,00FFFF,00FFFF,00FFFF,00FFFF,00FFFF,00FFFF,00FFFF
0,0,0,0,0,0,0,0,0,0
0,0,0,0,0,0,0,0,0,0
0,0,0,0,0,0,0,0,0,0
0,0,0,0,0,0,0,0,0,0
0,0,0,0,0,0,0,0,0,0
++
0,0,0,0,0,0,0,0,0,0
1,1,1,1,1,1,1,1,1,1
1,1,1,1,1,1,1,1,1,1
1,1,1,1,1,1,1,1,1,1
1,1,2,2,2,2,2,2,1,1
0,0,0,0,0,0,0,0,0,0
0,0,0,0,0,0,0,0,0,0
0,0,0,0,0,0,0,0,0,0
0,0,0,0,0,0,0,0,0,0
0,0,0,0,0,0,0,0,0,0
0,0,0,0,0,0,0,0,0,0
0,0,0,0,0,0,0,0,0,0
--
0,0,0,0,0,0,0,0,0,0
CCCCCC,CCCCCC,CCCCCC,CCCCCC,CCCCCC,CCCCCC,CCCCCC,CCCCCC,CCCCCC,CCCCCC
00FF00,00FF00,00FF00,00FF00,00FF00,00FF00,00FF00,00FF00,00FF00,00FF00
FF0000,FF0000,FF0000,FF0000,FF0000,FF0000,FF0000,FF0000,FF0000,FF0000
0000FF,0000FF,0000FF,0000FF,0000FF,0000FF,0000FF,0000FF,0000FF,0000FF
0,0,0,0,0,0,0,0,0,0
0,0,0,0,0,0,0,0,0,0
0,0,0,0,0,0,0,0,0,0
0,0,0,0,0,0,0,0,0,0
0,0,0,0,0,0,0,0,0,0
0,0,0,0,0,0,0,0,0,0
0,0,0,0,0,0,0,0,0,0
##